,g,mp,fg,fga,fg_pct,fg2,fg2a,fg2_pct,fg3,fg3a,fg3_pct,ft,fta,ft_pct,orb,drb,trb,ast,stl,blk,tov,pf,pts,pts_per_g,Team
0,33,6625,806,1857,.434,602,1206,.499,204,651,.313,372,558,.667,300,716,1016,430,198,119,444,536,2188,66.3,North Carolina Central
1,33,6650,885,1921,.461,641,1240,.517,244,681,.358,368,491,.749,264,824,1088,395,175,86,328,547,2382,72.2,North Dakota State
2,33,6700,841,1897,.443,602,1170,.515,239,727,.329,437,643,.680,325,897,1222,421,182,85,485,550,2358,71.5,Temple
3,32,6450,865,2041,.424,618,1320,.468,247,721,.343,383,549,.698,300,825,1125,390,197,112,398,533,2360,73.8,Belmont
4,34,6825,858,2171,.395,637,1418,.449,221,753,.293,360,521,.691,407,806,1213,418,222,108,498,600,2297,67.6,Duke
5,32,6450,678,1765,.384,515,1175,.438,163,590,.276,452,656,.689,366,763,1129,346,206,81,520,626,1971,61.6,VCU
6,31,6225,715,1810,.395,498,1117,.446,217,693,.313,346,536,.646,347,725,1072,388,174,86,380,665,1993,64.3,UCF
7,33,6650,824,1885,.437,583,1202,.485,241,683,.353,425,597,.712,338,720,1058,413,195,121,448,544,2314,70.1,Mississippi State
8,34,6800,741,1785,.415,525,1110,.473,216,675,.320,368,549,.670,285,753,1038,341,177,88,463,525,2066,60.8,Liberty
9,32,6450,690,1701,.406,407,848,.480,283,853,.332,324,449,.722,286,673,959,389,162,93,450,522,1987,62.1,Virginia Tech
10,35,7000,778,1900,.409,552,1178,.469,226,722,.313,449,625,.718,300,862,1162,427,207,138,455,660,2231,63.7,Saint Louis
11,32,6400,744,1876,.397,508,1137,.447,236,739,.319,358,498,.719,296,683,979,387,228,110,303,562,2082,65.1,Maryland
12,32,6575,821,1884,.436,570,1148,.497,251,736,.341,444,645,.688,353,726,1079,357,209,94,480,630,2337,73.0,LSU
13,29,5875,751,1828,.411,532,1127,.472,219,701,.312,402,549,.732,276,707,983,369,203,87,327,501,2123,73.2,Yale
14,33,6700,790,1949,.405,562,1230,.457,228,719,.317,430,617,.697,321,820,1141,383,193,114,375,637,2238,67.8,Louisville
15,34,6825,868,1999,.434,640,1326,.483,228,673,.339,388,566,.686,336,836,1172,436,203,153,385,653,2352,69.2,Minnesota
16,34,6850,793,2098,.378,546,1320,.414,247,778,.317,395,582,.679,372,714,1086,421,218,100,349,622,2228,65.5,Michigan State
17,34,6825,756,1838,.411,515,1104,.466,241,734,.328,456,638,.715,305,822,1127,406,193,85,424,630,2209,65.0,Bradley
18,34,6900,874,1978,.442,606,1209,.501,268,769,.349,412,592,.696,376,764,1140,451,209,110,497,612,2428,71.4,Fairleigh Dickinson
19,35,7000,863,1887,.457,648,1207,.537,215,680,.316,606,875,.693,393,922,1315,445,174,152,637,759,2547,72.8,Prairie View
20,33,6675,831,1912,.435,553,1096,.505,278,816,.341,528,746,.708,348,933,1281,450,171,80,508,560,2468,74.8,St. John's (NY)
21,32,6500,775,1878,.413,501,1062,.472,274,816,.336,514,725,.709,320,811,1131,425,203,111,445,693,2338,73.1,Arizona State
22,33,6600,788,2028,.389,571,1326,.431,217,702,.309,354,509,.695,357,715,1072,324,170,64,447,617,2147,65.1,Gonzaga
23,33,6625,718,1806,.398,440,946,.465,278,860,.323,454,628,.723,396,826,1222,486,218,104,516,608,2168,65.7,Syracuse
24,32,6425,743,1762,.422,516,1097,.470,227,665,.341,437,643,.680,320,699,1019,411,191,135,397,577,2150,67.2,Baylor
25,33,6675,789,1964,.402,565,1262,.448,224,702,.319,478,701,.682,333,772,1105,395,230,97,390,630,2280,69.1,Marquette
26,31,6200,767,1869,.410,582,1214,.479,185,655,.282,382,531,.719,347,709,1056,347,179,106,440,548,2101,67.8,Murray State
27,34,6900,774,1891,.409,535,1157,.462,239,734,.326,495,683,.725,325,787,1112,342,187,102,486,631,2282,67.1,Florida State
28,33,6650,747,1779,.420,510,1098,.464,237,681,.348,336,466,.721,232,779,1011,347,178,90,432,639,2067,62.6,Vermont
29,34,6825,863,2064,.418,635,1310,.485,228,754,.302,444,642,.692,343,918,1261,349,175,105,528,664,2398,70.5,Buffalo
30,32,6425,626,1699,.368,423,1026,.412,203,673,.302,442,639,.692,324,706,1030,305,204,78,501,602,1897,59.3,Texas Tech
31,34,6850,806,1934,.417,568,1173,.484,238,761,.313,488,675,.723,315,795,1110,410,199,125,455,621,2338,68.8,Northern Kentucky
32,33,6600,791,1933,.409,533,1161,.459,258,772,.334,358,533,.672,303,851,1154,412,150,80,450,698,2200,66.7,Nevada
33,34,6875,763,1803,.423,544,1118,.487,219,685,.320,419,607,.690,362,798,1160,372,209,96,503,584,2164,63.6,Florida
34,34,6800,760,1903,.399,600,1349,.445,160,554,.289,311,474,.656,305,878,1183,344,126,114,407,508,1991,58.6,Michigan
35,34,6825,798,1852,.431,567,1175,.483,231,677,.341,496,662,.749,281,772,1053,360,189,96,460,595,2323,68.3,Montana
36,33,6625,855,2068,.413,566,1190,.476,289,878,.329,408,597,.683,305,825,1130,467,222,157,466,589,2407,72.9,UNC
37,32,6400,865,1946,.445,558,1111,.502,307,835,.368,383,561,.683,352,845,1197,483,175,118,425,600,2420,75.6,Iona
38,34,6850,765,1957,.391,493,1174,.420,272,783,.347,469,661,.710,286,778,1064,388,207,113,417,666,2271,66.8,Utah State
39,34,6825,763,1841,.414,548,1191,.460,215,650,.331,448,635,.706,394,768,1162,446,209,84,551,626,2189,64.4,Washington
40,35,7050,808,1865,.433,517,1041,.497,291,824,.353,477,675,.707,373,851,1224,419,203,125,615,607,2384,68.1,Auburn
41,34,6825,763,1825,.418,523,1101,.475,240,724,.331,415,590,.703,231,748,979,291,164,64,450,691,2181,64.1,New Mexico State
42,34,6875,850,2083,.408,560,1219,.459,290,864,.336,393,577,.681,372,837,1209,449,220,117,438,587,2383,70.1,Kansas
43,33,6725,855,1870,.457,629,1198,.525,226,672,.336,383,524,.731,263,781,1044,391,179,69,371,577,2319,70.3,Northeastern
44,34,6800,854,2039,.419,583,1237,.471,271,802,.338,344,481,.715,376,799,1175,426,176,90,429,556,2323,68.3,Iowa State
45,33,6625,765,1820,.420,540,1139,.474,225,681,.330,430,578,.744,295,807,1102,389,196,103,407,616,2185,66.2,Ohio State
46,34,6800,690,1880,.367,477,1107,.431,213,773,.276,489,707,.692,338,804,1142,346,181,78,417,595,2082,61.2,Houston
47,33,6600,839,1987,.422,543,1090,.498,296,897,.330,433,618,.701,416,869,1285,490,166,103,501,581,2407,72.9,Georgia State
48,33,6650,772,1810,.427,536,1077,.498,236,733,.322,385,550,.700,253,708,961,376,180,84,460,510,2165,65.6,Wofford
49,33,6675,819,1920,.427,562,1155,.487,257,765,.336,462,625,.739,346,839,1185,438,192,146,468,607,2359,71.5,Seton Hall
50,33,6625,769,1907,.403,513,1176,.436,256,731,.350,365,517,.706,308,668,976,371,187,99,414,648,2159,65.4,Kentucky
51,33,6650,723,1681,.430,536,1117,.480,187,564,.332,449,624,.720,281,772,1053,343,186,91,548,573,2082,63.1,Abilene Christian
52,32,6425,636,1675,.380,450,990,.455,186,685,.272,304,467,.651,289,665,954,279,166,88,351,505,1762,55.1,Virginia
53,34,6950,843,2047,.412,540,1119,.483,303,928,.327,408,566,.721,382,812,1194,458,196,99,453,591,2397,70.5,Gardner-Webb
54,32,6425,798,1810,.441,563,1179,.478,235,631,.372,421,601,.700,327,722,1049,444,193,110,467,550,2252,70.4,Ole Miss
55,32,6425,796,1978,.402,526,1168,.450,270,810,.333,321,476,.674,348,837,1185,398,218,117,391,551,2183,68.2,Oklahoma
56,33,6725,746,1899,.393,538,1232,.437,208,667,.312,327,492,.665,322,851,1173,340,170,133,375,575,2027,61.4,Wisconsin
57,35,7050,747,1860,.402,500,1020,.490,247,840,.294,462,657,.703,340,807,1147,416,183,96,487,589,2203,62.9,Oregon
58,33,6600,695,1678,.414,471,960,.491,224,718,.312,341,512,.666,271,794,1065,382,204,94,490,547,1955,59.2,Kansas State
59,35,7100,760,1998,.380,540,1335,.404,220,663,.332,476,675,.705,356,790,1146,331,182,94,399,594,2216,63.3,UC-Irvine
60,34,6875,825,1903,.434,575,1156,.497,250,747,.335,381,545,.699,318,792,1110,464,182,78,394,630,2281,67.1,Villanova
61,33,6625,779,1785,.436,601,1225,.491,178,560,.318,388,525,.739,248,713,961,334,164,111,351,529,2124,64.4,Saint Mary's
62,32,6450,732,1739,.421,475,991,.479,257,748,.344,417,569,.733,285,728,1013,404,154,121,417,540,2138,66.8,Purdue
63,34,6800,716,1833,.391,477,1098,.434,239,735,.325,396,594,.667,302,854,1156,378,165,84,413,561,2067,60.8,Old Dominion
64,34,6850,737,1816,.406,464,1038,.447,273,778,.351,368,554,.664,328,727,1055,373,132,125,462,644,2115,62.2,Cincinnati
65,33,6650,887,1979,.448,620,1160,.534,267,819,.326,389,569,.684,343,802,1145,524,220,90,433,680,2430,73.6,Iowa
66,34,6875,806,2021,.399,532,1209,.440,274,812,.337,448,684,.655,399,763,1162,421,217,86,439,635,2334,68.6,Tennessee
67,34,6875,854,1969,.434,586,1171,.500,268,798,.336,405,569,.712,315,759,1074,441,243,107,414,569,2381,70.0,Colgate
